10
20
20
xxxxxxxxxxxxxxxxxxxx
x.......xx.........x
x.......xx.........x
x..xx...xx.........x
x..xx..............x
x..xx........xx....x
x..xx.....xxxxxxxxxx
x..xx.....xxxxxxxxxx
x..xx........xx....x
x..xx........xx....x
x..xx..xx....xx....x
x..xx........xx....x
xxxxxxxx.....xx.xxxx
xxxxxxxx.....xx.xxxx
x..xx........xx....x
x..xx..............x
x..xx....xx........x
x........xx........x
x........xx........x
xxxxxxxxxxxxxxxxxxxx